2 7

4 4 4 4 4 4 4 4 4 4
4 1 1 1 1 1 1 1 1 4
4 1 0 0 0 0 3 3 1 4
4 1 0 0 0 0 0 0 1 4
4 1 0 0 0 0 0 0 1 4
4 1 0 0 0 0 2 2 1 4
4 1 0 0 0 0 0 0 1 4
4 1 0 0 0 0 0 0 1 4
4 1 1 1 1 1 1 1 1 4
4 4 4 4 4 4 4 4 4 4 
